NO ./textures/north.xpm
SO ./textures/south.xpm
WE ./textures/west.xpm
EA ./textures/east.xpm

F 220,100,0
C 225,30,0

  1111111111111111 1111111111
  1000000000000001 1000000001
  1000001111110001 1111111001
  1000001    10001       1001
  1000001    11111 1111  1001
  1000001          1001  1001
  100000111111111111001111001
  1000000000000000000N0000001
  111111111111110000000000011
             10000000000001
             11111111111111
